13 14
0000000000000
0000000000000
00#########00
00#*******#00
00#*SSSPSP#00
00#***###P#00
00#*SS#*PP#00
00#*S***P##00
00#*S***P##00
00#*SS#*P$#00
00#******P#00
00#########00
0000000000000
0000000000000