14 14
00000000000000
00000000000000
00####00000000
00#**#00000000
00#*S#00000000
00#**####00000
00#*SS**#00000
00#**#*S#00000
00#**#**####00
00#*SS*SSB*#00
00#PPPPPPPP#00
00##########00
00000000000000
00000000000000