15 13
000000000000000
000000000000000
00###########00
00#*********#00
00#*S##P##S*#00
00#*S*PPP*S*#00
00#*S*P*P*S*#00
00#*S*PPP*S*#00
00#*S##P##S*#00
00#********B#00
00###########00
000000000000000
000000000000000