16 15
0000000000000000
0000000000000000
00############00
00#********@*#00
00#*@@@@@@*@*#00
00#*@****@*@*#00
00#*@*@**@*@*#00
00#*@*@B*@*@*#00
00#*@*@@@S*@*#00
00#*@******@*#00
00#*@@@@@@@@P#00
00#**********#00
00############00
0000000000000000
0000000000000000