23 13
00000000000000000000000
00000000000000000000000
00###################00
00#********#********#00
00#*S*S*S**#**P*P*P*#00
00#**S*S*S*#*P*P*P**#00
00#*S*S*S*S*P*P*P*P*#00
00#**S*S*S*#*P*P*P**#00
00#*S*S*S**#**P*P*P*#00
00#********#*******B#00
00###################00
00000000000000000000000
00000000000000000000000