21 18
000000000000000000000
000000000000000000000
000000000000#######00
000000000000#**PPP#00
00000000#####**PPP#00
00000000#******P*P#00
00000000#**##**PPP#00
00000000##*##**PPP#00
0000000###*########00
0000000#*SSS*##000000
00######**S*S*#####00
00##***#S*S***#***#00
00#B*S**S****S**S*#00
00######*SS*S*#####00
0000000#******#000000
0000000########000000
000000000000000000000
000000000000000000000