13 13
0000000000000
0000000000000
00#########00
00#****PPP#00
00#*#*#P#P#00
00#*#**PPP#00
00#*SSS*#*#00
00#*SBS***#00
00#*SSS##*#00
00#*******#00
00#########00
0000000000000
0000000000000



