10 11
0000000000
000#####00
0###***#00
0#PBS**#00
0###*SP#00
0#P##S*#00
0#*#*P*##0
0#S*@SSP#0
0#***P**#0
0########0
0000000000
