21 11
000000000000000000000
000000000000000000000
00#####00000######000
00#***#######****#000
00#*#***PPP##*SSS##00
00#*##**P*P***SBS*#00
00#*##*#PPP##*SSS*#00
00#****######*****#00
00######0000#######00
000000000000000000000
000000000000000000000