11 11
00000000000
00000000000
00#######00
00#P***P#00
00#*SSS*#00
00#*SBS*#00
00#PSSSP#00
00#PP*PP#00
00#######00
00000000000
00000000000