15 10
000000000000000
000000000000000
00###########00
00#*PPP#PPP*#00
00#***SBS***#00
00#*SS###SS*#00
00#***#0#***#00
00#####0#####00
000000000000000
000000000000000